000000000000000000010
010111110111111111010
010101000101000001010
010101111101111101110
010100000001000100010
011101111111011101010
010001000001010001010
011101011111010111110
000100010000010000010
010111011111111111010
010001000101000001010
011101110101111101010
010100010100000101000
010111110111110101010
010000000001010101010
011101111111010101110
000101000001000100000
010101111101111101110
010100000100000100010
011111111101111111110
010000000000000000000