000000000000000000010
011111110111111101110
010000010001000001010
010111011101111111010
010101000101000000010
010101011101111101110
010100010000000001010
010111111111111111010
010000000000000100010
011111111101110111110
010000010100010100000
010111110101110111110
010100010101000000010
010111011101011111010
010001000001010100010
011101011111110111110
010001000000000000010
011111111111111111110
010100000000000001010
010111111111111111010
010000000000000000000