000000000000000000010
010111011111011101110
010001010001010101010
010111010101010101010
010100010101010100010
010111110101010111110
010000000101010000010
011111111111011101110
010000000101000101000
010111111101111101010
010100000000010001010
010111110111110111010
010000010001000100010
010111011111011101110
010101000001010001010
010101011111010111010
010101010000010000010
010101011111011101110
010101000000000101010
011101111111111111010
010000000000000000000