000000000000000000010
010111011111111101110
010101010000010101010
011101110111110111010
010000000100010000010
010111110111010111110
010000010001000100010
010111011101011111010
010101010101010000010
011101110101110111110
000000000100010100000
011111110111110111010
010000010000010000010
010111011111010111110
010001000001010101000
011101011111010101110
000101010001010100010
010111010111010111010
010001010000010000010
011111111111111111110
010000000000000000000