000000000000000000010
011111111111011111110
010000000001110101010
011111110111010101010
000000000100010101000
011101111101111101110
010101000001000000010
010111011111110111010
010000010000000101010
011111111101111101110
010000000001000000010
011101011101111101110
000101000100000100000
011101110111110111110
010100010000010100010
010111111111010111010
010000000001010100010
011111111101010101110
010000010001010001010
011111011111011111010
010000000000000000000