000000000000000000010
011111011111011111110
010001000101000000010
011101111101111111010
010100000000000101010
010101111101111101110
010101000101010000010
010101011111010111110
000101000000000100000
011101111111111101110
010001000100000001000
011101011101111101010
010101010100010101010
010101110111110111010
000100000101000000010
011111111101011111010
010001000100010001010
010111010111011101110
010100010001000100000
011111111101111111110
010000000000000000000