000000000000000000010
011101110111111111110
000101010000000001000
011101011111011101110
010101000001010100010
010101110111110111110
010100010100010000010
010101010101110111110
010101010101010100000
010101010101010101110
010101010001000100010
010101011111010111010
010101010000010001010
010111110111111101110
010000000100010100010
011111111101110111010
010000000001000001010
010111111101111101010
010001000100010100010
011111011111110111110
010000000000000000000