000000000000000000010
011111111111011111110
010001000001010000010
010111011111011101010
010000010001000101010
011101110111111101110
010101000000000101000
010101111101110101010
010100000101010101010
010101111101011101110
000101000001000000010
011111011111011101110
010001010000010001000
011101110111111101110
010100000100000100010
010111011101111111010
010101010001000001010
010101010101011111010
010100010101000000010
010111111101111111110
010000000000000000000