000000000000000000010
011111111111111101110
000000000100000101010
011111111101111111010
010000000001000000010
011111111101111111010
000101000101010100010
010101110111010101110
010101010001010101000
010101011111010101110
010001000000010000010
011111011101111111010
010000010101000001010
011111010101111101010
010001010100000101010
011101010111110101110
000101010100000100000
011101110111110101110
010000000000010100010
011111111111011111110
010000000000000000000