000000000000000000010
011111111111011111110
010100000001010100010
010101111111010101110
000101000000010101000
011101011111110101010
010001000100000101010
010101111101111101110
010100000101000000010
010111111101111111010
010001000001000101010
011111110111011101010
000101010100010100010
010101011101110101110
010100000101000001000
010111110101111101010
010100010100000101010
010111010101110101010
010101000100010101010
011101111111110111110
010000000000000000000